Explicacion ejercicio 1:

<?xml version="1.0" encoding="UTF-8"?>	 Esta línea indica al programa que recibe un archivo de datos en XML

<xs:schema xmlns:xs="http://www.w3.org/2001/XMLSchema" elementFormDefault="qualified">	 Es un elemento raíz del documento XSD que se utiliza para controlar el uso de espacios de nombres en documentos de instancia XML 
																							
<xs:element name="biblioteca">	El elemento name especifica el nombre de esta biblioteca

<xs:complexType> El elemento complexType define un tipo complejo. 

<xs:sequence>  Indica que los elementos secundarios solo aparecen en el orden mencionado.

<xs:element ref="libro" minOccurs="2" maxOccurs="unbounded"/>	 Atributo que indica que el elemento puede aparecer varias veces.Si especificamos maxOccurs=”unbounded”, el elemento puede aparecer un número indefinido de veces.

</xs:sequence>	Cierra la secuencia.

</xs:complexType>	Cierra el elemento complejo.

</xs:element>	 Cierra la etiqueta del elemento.

<xs:element name="libro"> Empieza la definición del elemento name.

<xs:element name="autor" type="xs:string"  maxOccurs="3"/>	 Define el elemento autor, pudiendo aparecer el elemento entre 1 y 3 veces y es de tipo texto.

<xs:element name="editorial" type="xs:string" minOccurs="0" maxOccurs="1"/>	 Define el elemento editorial, pudiendo aparecer o no y es de tipo texto.

<xs:element name="edicion" type="xs:string"/>	 Define el elemento edicion y es de tipo texto.

<xs:element name="isbn" type="xs:string"/>	  Define el elemento isbn y es de tipo texto.

<xs:element name="donacion" type="xs:string" minOccurs="0" maxOccurs="1"/>	 Define el elemento donacion y es opcional y es de tipo texto.

<xs:element name="ubicacion" type="tipoUbicacion"/>	 Define el elemento  ubicacion y es de tipo personalizado

<xs:attribute name="codigo" type="xs:string" use="required"/>	Define el atributo codigo y es de tipo texto y tiene uso obligatorio("required")

<xs:attribute name="titulo" type="xs:string" use="required"/>	Define el atributo titulo y es de tipo texto y tiene uso obligatorio("required")

<xs:complexType name="tipoUbicacion">  Define el tipo personalizado tipoUbicacion y es de tipo no simple ya que contiene un atributo.

<xs:attribute name="sede" use="required">	Define el  atributo sede y es de tipo simple

<xs:simpleType>	 Indica que el atributo es de tipo simple.

<xs:restriction base="xs:string">	Indica la estructura y las restricciones de los contenidos de los documentos XML de una forma muy precisa

<xs:enumeration value="norte"/>		Indica que la restricción es de carácter enumerado.

<xs:enumeration value="sur"/>		Lo mismo que en lo anterior pero en este caso indica que es sur, en el anterior era norte

</xs:restriction>	 Cierra la declaración de la restricción.

</xs:simpleType>	Cierra la definición del tipo simple.

</xs:attribute>		Cierra la definición del atributo.

</xs:complexType>	 Cierra la definición del tipo personalizado.

</xs:schema>	 Cierra el archivo XSD